# AppTheory TypeScript public API snapshot
# Source: ts/dist/index.d.ts
# SHA256: 9fd629be7daef0ba20857f4546ff3c501a3e9bfdc111653a1d735ae9588cf105
# Generated by: scripts/update-api-snapshots.sh
# DO NOT EDIT MANUALLY

[exports]
ALBTargetGroupRequest	interface
ALBTargetGroupResponse	interface
APIGatewayProxyRequest	interface
APIGatewayProxyResponse	interface
APIGatewayV2HTTPRequest	interface
APIGatewayV2HTTPResponse	interface
APIGatewayWebSocketProxyRequest	interface
App	class
AppError	class
AppTheoryError	class
AppTheoryErrorDetails	type
AppTheoryErrorOptions	type
AtomicRateLimiter	interface
AuthHook	type
CORSConfig	interface
Clock	interface
Config	interface
Context	class
DynamoDBStreamEvent	interface
DynamoDBStreamEventResponse	interface
DynamoDBStreamHandler	type
DynamoDBStreamRecord	interface
DynamoRateLimiter	class
ErrorType	type
EventBridgeEvent	interface
EventBridgeHandler	type
EventBridgeSelector	interface
EventContext	class
EventHandler	type
EventMiddleware	type
FakeWebSocketManagementClient	class
FixedWindowStrategy	class
Handler	type
Headers	type
IDGenerator	type
IdGenerator	interface
KinesisEvent	interface
KinesisEventRecord	interface
KinesisEventRecordInput	type
KinesisEventResponse	interface
KinesisHandler	type
KinesisRecord	interface
LambdaFunctionURLRequest	interface
LambdaFunctionURLResponse	interface
LambdaFunctionURLStreamingHandler	type
Limit	interface
LimitDecision	interface
Limits	interface
LogFields	type
LogRecord	interface
ManualClock	class
ManualIdGenerator	class
MetricRecord	interface
Middleware	type
MultiWindowStrategy	class
ObservabilityHooks	interface
PolicyDecision	interface
PolicyHook	type
Query	type
RandomIdGenerator	class
RateLimitEntry	interface
RateLimitKey	interface
RateLimitStrategy	interface
RateLimitWindow	type
RateLimiter	interface
RateLimiterError	class
RealClock	class
Request	interface
Response	interface
RouteOptions	interface
SNSEntity	interface
SNSEvent	interface
SNSEventRecord	interface
SNSEventRecordInput	type
SNSHandler	type
SQSEvent	interface
SQSEventResponse	interface
SQSHandler	type
SQSMessage	interface
SSEEvent	interface
SlidingWindowStrategy	class
SpanRecord	interface
StructuredLogger	interface
TestEnv	class
Tier	type
TimeWindow	interface
TimeoutConfig	interface
UsageStats	interface
UsageWindow	interface
WebSocketCall	interface
WebSocketClientFactory	type
WebSocketContext	class
WebSocketManagementClient	class
WebSocketManagementClientLike	interface
WindowConfig	type
WindowLimit	interface
XMLSanitizationPattern	interface
appTheoryErrorFromAppError	const
baseName	function
binary	function
buildALBTargetGroupRequest	function
buildAPIGatewayV2Request	function
buildDynamoDBStreamEvent	function
buildEventBridgeEvent	function
buildKinesisEvent	function
buildLambdaFunctionURLRequest	function
buildSNSEvent	function
buildSQSEvent	function
buildStepFunctionsTaskTokenEvent	function
cacheControlISR	function
cacheControlSSG	function
cacheControlSSR	function
clientIP	function
createApp	function
createLambdaFunctionURLStreamingHandler	function
createTestEnv	function
defaultConfig	function
etag	function
formatRfc3339Nano	function
formatWindowId	function
getDayWindow	function
getFixedWindow	function
getHourWindow	function
getLogger	function
getMinuteWindow	function
html	function
htmlStream	function
isAppTheoryError	const
json	function
matchesIfNoneMatch	function
newError	function
normalizeStage	function
originURL	function
paymentXMLPatterns	const
paymentXMLPatterns	re-export
rapidConnectXMLPatterns	const
rapidConnectXMLPatterns	re-export
rateLimitTableName	function
resourceName	function
safeJSONForHTML	function
sanitizeFieldValue	function
sanitizeFieldValue	re-export
sanitizeJSON	function
sanitizeJSON	re-export
sanitizeLogString	function
sanitizeLogString	re-export
sanitizeXML	function
sanitizeXML	re-export
setKeys	function
setLogger	function
sse	function
sseEventStream	function
stepFunctionsTaskToken	function
text	function
timeoutMiddleware	function
unixSeconds	function
vary	function
wrapError	function
